####################
#####A##############
##### ##############
#####     ##########
##### ### ##########
#####  B  ##########
####################
